Jitterbit	VB5	Xinet	33
RPG Free	HtmlUnit	MM7	31
Nursing Process	JIT	SQR	39
RHEL	CTQ	PY	30
Xoops	VBScript	Rheology	35
Utilization	EEO	Electrical Troubleshooting	14
MBD	Aerial Silks	Yarn	8
DV	Osteopathy	Agile &amp; Waterfall Methodologies	6
Utility Locating	Kettlebells	PMO Services	50
Military Operations	Lymphoma	Agile Application Development	13
Backbone.js	NHibernate	Long Distance Running	49
AQL	Drawing	DWR	10
HP XP	GNU Radio	Afghanistan	38
Hospitality Management	NAS	Xcart	21
International Relations	BPD	Oozie	33
Ergonomics	EPM	Vital Signs	18
Real Estate Financing	MPIO	GCF	31
First Year Experience	EBPP	HP Data Protector	32
USDA Rural Housing	USDA Rural Housing	Driven By Results	8
AKTA	Web Typography	Policy Writing	35
AAP	Ab Initio	EF	1
BGP	Multithreading	BCMS	39
CQI	Fashion Photography	Technical Writing	24
Academic Tutoring	Keyboardist	Aerohive	49
Rural Development	EGPRS	HSM	14
Corona SDK	XMPP	DFP	7
Oracle OLAP	E-Learning	EBIT	31
GT Strudl	Software Quality Assurance	AHU	17
MCAD	Jerseys	Natural Language Processing	24
SMED	MKS Integrity	Xilinx	14
Nastran	Healthcare Information Technology	AutoCAD	3
HTTPS	DDoS	Computer Network Operations	7
Digital TV	Identity Theft	User Acceptance Testing	37
Windows NT	Applied Behavior Analysis	Komodo	30
GSI	Market Research	Rural Marketing	8
Crystal Xcelsius	Capacity Utilization	Media TV	44
Education	Rapid Prototyping	Online Advertising	16
IHE	Youth Empowerment	RSA enVision	23
QuarkXPress	Academic Advising	Euthanasia	25
EBITDA Growth	Kodaly	Patient Education	24
Nios II	QROPS	Linux Kernel	40
Corona SDK	XCOM	DDE	41
Drug Development	Geometric Dimensioning &amp; Tolerancing	Church Events	35
DNA microarray	VST	Small Business Online Marketing	40
IFS ERP	Seismic Attributes	Hydraulic Fracturing	20
Microsoft Dynamics SL	Game Design	FBO	5
Integrated Marketing	Modeling	OmniPage	16
Unix	Alternative Medicine	HDF5	35
Eastern Europe	Improvisation	Registered Patent Attorney	47
Solaris Zones	Pharmaceutics	iWork	9
Digital TV	DXX	LDPE	13
Luxury Homes	VTL	NMLS	9
JDeveloper	Pygame	KCS	38
Class III Medical Devices	Mobile Devices	Vray	32
ICP	SPC	VMware View	1
MDR	SAP XI	Zotero	49
IFS	Benefits Negotiation	Gift Baskets	8
WLST	Mergers &amp; Acquisitions	XAUI	40
RMF	PWS	Sheet Metal	4
Situational Awareness	Audio Editing	MMR	32
JSTOR	Small Business Marketing	Microsoft Office	45
Phase II Environmental Site Assessments	Digital Media	Syslog-ng	11
Working at Height	IEX	CPA	41
XMetal	XAUI	CCSP	44
Volunteer Training	SRX	NFPA 101	45
TSO	USB	QuarkXPress	6
OEM contracts	Compliance Oversight	NI Multisim	27
Working Capital Management	CMC	Corel Draw	47
Cisco Nexus	Embedded Software	SSD	9
Order Fulfillment	MRI Plus	Electric Guitar	10
Mental Health	Rent to Own	Protein Expression	36
Financial Services	LSF	Olefins	24
Urban Infill	Litigation	Mentoring	14
OLAP Cube Studio	HP Servers	Financial Statements	14
Grant Writing	Traditional IRA	QSE	8
HW development	Operational Due Diligence	Tomcat	9
DSM-IV	Account Management	Cashiering	11
QRadar	MPE	Capacity Building	30
Urdu	QSI	1H NMR	45
Global Human Resources Management	UIM	Scrum	32
Real Estate Financing	Holistic Health	CQA	46
Clinical Development	IxChariot	LPN	37
Gift Tax	ZigBee	PWM	2
CBP	Curriculum Development	Menu Development	15
MVT	Lyric Soprano	RTOS	33
Axioma	FSA	Okuma	38
Data Mining	Owners Representative	Psychopharmacology	31
WordPress	Web Development	Logic Pro	46
Physical Security	Verilog	Ghostwriting	45
Motion Graphics	PKCS#11	Video	23
High Sense Of Urgency	vCenter Server	NCDA	19
Drums	FBO	RCCA	45
Breaking News	American Literature	LDO	4
Hiring	Jetty	WSIB Claims Management	25
HSE Management Systems	PPA	Euthanasia	18
DCN	Distance Learning	Industrial Ethernet	49
Typewriter	Teaching Writing	Online Lead Generation	46
VMware Fusion	SAP PP	Whisky	44
LVM	CPLD	Jing	15
PCS7	Lithium-ion Batteries	EViews	40
Gnome	Hydrology	American Welding Society (AWS)	24
RDCS	Molecular Dynamics	3D Visualization	42
Summation iBlaze	Ideas Development	LCMS	4
CNC Operation	IFR	Microsoft Dynamics GP	46
DMR	HP NonStop	Myofascial	10
Ironport	Mobile Technology	PLC Allen Bradley	5
DSM-IV	CPOE	UHF	28
Yacht Charters	TMJ Treatment	BSI Tax Factory	40
HMS	Integrated Marketing	EEG	26
XMPie	Wealth Management	Site Plans	16
Employee Engagement	CDL Class A	SnapMirror	6
Interpersonal Skills	International Tax	TL9000	33
KDE	Luciferase Assay	Hardware	20
Active DoD Secret Clearance	Xytech	Lymphedema	30
Legislative Affairs	TCF	Jewelry	35
JDA	Gynecology	ASME	35
SFX	GNSS	RTGS	27
BPF	Failure Analysis	Variance Analysis	8
DNA ligation	CGI	DCF	33
Wills	TBMCS	Bhangra	24
OGC	Non-compete Agreements	NIR Spectroscopy	33
UCC filings	Secretarial Skills	Nanomaterials	31
RC	OSPF	Food Preparation	43
SLA	FX Derivatives	Injection Molding	29
Simple IRA	Sports Injuries	Prototype.js	15
EIP	Swift	Myriad	45
Acoustic Guitar	FX Derivatives	AQL	13
AWR Microwave Office	Risk Management	Gyrokinesis	47
Politics	ESL	TSCA	13
DNA methylation	JBoss Seam	Upstream	49
KDB	VTAM	RMA	26
Business Aviation	Ice Cream	LDRA	38
RTA	Western Europe	UV/Vis	40
Zoning	Project Estimation	Kindergarten	16
SSL Duality	JSONP	Microsoft DNS	24
Subversion	LPCVD	TL9000	2
GNU C++	Microsoft Dynamics ERP	IEC 60601	4
KPI Implementation	Kernel Programming	Policy Writing	23
PBUSE	CTRM	UFS	34
ERP Software	Entity Framework	Youth Leadership	46
Registered Nurses	RFQ	Metro Ethernet	48
NSPS	Yacht Racing	RF Troubleshooting	27
NCIDQ	Nutrition	AHDL	44
Etching	Gmail	Radio Production	46
Drafting Agreements	RTCP	Process Optimization	5
Image Editing	ALM	JReport	50
Iron	IP	RS485	26
ETFs	PFS	Wastewater Treatment	35
Shared Services	SG&amp;A	Process Piping Design	38
Aerospace Industries	GDS systems	JVC	43
AWR Microwave Office	HP Quality Center	TPU	34
Customer Acquisition	VTS	TCAP	45
JCT	DHTMLX	Tutoring	29
Functional Verification	US Tax	RS/6000	49
QAM	Sports Play-by-play	Long Distance Running	19
Database Design	Federal Law Enforcement	JCE	10
TDM	Criminal Investigations	TJC	26
UCaaS	Oil &amp; Gas	Investment Banking	9
Cleaning Validation	Visual Arts	Interviewing Skills	31
IB	BIM	Emergency Room	33
BCLS	Creative Strategy	Channel Partners	24
Long Distance Running	Weddings	Business Owner Planning	36
FDDI	DVCProHD	Physicians	5
DVB-H	Organizational Leadership	OAS Gold	43
CBI	Visio	Telephone Skills	45
Mythology	Slate	GMP	41
Amazon Kindle	JCL	Estate Planning	35
HTML Scripting	Voice Over	HDV	13
VSE	Google Docs	Government Relations	24
Troubleshooting	CTMS	JDeveloper	50
TVC	Medical Billing	Equity Capital Markets	33
Enterprise Architecture	FCAPS	Call Centers	40
Zumba	Tax Research	Hunting	38
HP Procurve	DoD	IEC	10
Guest Service Management	Guest Recovery	VCT	39
Overseas Sourcing	TMA	KML	44
Easytrieve	LSS	Solar PV	17
CBCP	CTA	Lytec	39
Quality Improvement	RS/6000	Event Production	32
Zend Certified Engineer	WF	Khalix	21
VoIP	LPG	RDCS	5
Global Business Development	Yield Management	Therapists	48
NRF	DBI	OWA	46
Online Gaming	Oil Changes	CNC Programming	17
MM modules	SAP ERP	Pthreads	7
Sybase SQL Anywhere	TPT	Cerner	1
Criminal Investigations	GL	Content Writing	40
GPS Devices	OSGi	HMO	5
eBay	Tunnels	CDMA2000	44
Kinesio Taping	Small Business Lending	IS-IS	5
Piloting	IEC 61850	Luxury Lifestyle	4
Ethical Decision Making	XBR	Vsftpd	1
MPower	Environmental Issues	Database Administration	23
Sqoop	OHSAS 18001	Road	27
Administration	RTSP	SAP SD	50
SharePoint	MSDS	Yii	22
Homeland Security	Americans with Disabilities Act	Spring DM	42
Switches	Sports Injuries	RTO	24
GML	Claims Management	MPLS VPN	4
JSP440	Construction	Xcode	18
Differentiated Instruction	Account Management	Process Improvement	18
Ufile	Swimming	CFIA	34
SBS	CPL	NCPDP	32
CCNP	DITA XML	Back Office	46
Product Life Cycle	Consumer Electronics	Early-stage Startups	48
Yii	Failure Analysis	AAC	42
Komodo Edit	QuickBooks	DWDM	3
MICROS	Typewriter	Flyers	40
XFOIL	RHCE	Facilities Management	28
QML	SFDC	Mood Boards	32
3D Modeling	Sqoop	Hadoop	8
21 CFR Part 11	RS/6000	Yield	19
Global Sourcing	CCU	Ultimate Frisbee	38
KDevelop	Direct Sales	Sports Play-by-play	7
RPL	Credit Analysis	GCCS	12
Threat &amp; Vulnerability Management	EOU	HSS	46
Drupal	Reverse Osmosis	Venture Capital	39
Channel Partners	IFR	Petroleum Geology	18
Bhangra	WSUS	Yarn	45
Logging	CFIA	Proposal Writing	3
RS485	DUI Defense	Typing	18
QNX	EWM	HP QTP	47
IEF	NVQs	Electrical Engineering	37
Piano Playing	VLC	Urinalysis	18
Unity3D	European Markets	Emergency Management	27
DPR	HTTPS	MBTI	32
For Sale By Owner	Volunteer Management	MVA	2
Corporate Events	Low Voltage	Certified DDI Facilitator	21
ISO	Brand Management	Historical Research	15
HP EVA	IP PBX	Mixed-use	5
Zsh	ODIN	JRuby	26
Abstracting	Factory	Kofax	18
EOL	Jitter	SVM	45
GXT	Electric Power	WSRR	23
JDA	SGSN	AAT	40
Retail Banking	JBoss EAP	LGD	9
RNO	Nios II	PTCRB	10
NGOSS	ATR-FTIR	CV	16
SIP Trunking	CICS	Pivot Tables	27
Small Business Lending	Gstreamer	General Aviation	21
Sales	OmniGraffle	VOD	1
VMware Workstation	fMRI	Oz Principle	39
Ruby on Rails	French	Oracle RDC	24
Rehabilitation Psychology	Kronos	Publishing	14
VHDL	PMO set-up	ICU	38
NLP	MHE	Motivational Interviewing	21
Legal Documents	OS X	Platform LSF	31
Jerseys	Apache	RTO	6
QML	WWAN	Vyatta	22
RFP Design	XML Standards	DVD Duplication	11
Ozone Therapy	Field Work	Curriculum Design	25
Civil Society	DB2	Finance	40
UF/DF	GIS systems	Revenue Cycle	25
PDMS	NRP Instruction	Fashion GPS	13
SR&amp;ED	NCAA Compliance	Google Apps	19
Non-compete Agreements	SD	Lync	44
Satellite TV	Silhouette FX	WLM	2
DS4000	Tax Law	IoC	42
Experion PKS	MRB	Drywall	50
DG Sets	Cash Management	Interactive TV	6
Ticketing	LLU	BTL Activations	48
FMOD	CSRs	Military Justice	36
Timber	ISO	EP	38
International HR	APO SNP	IntelliJ IDEA	12
First Time Home Buyers	Fluid Dynamics	TCLEOSE Instruction	34
Twisted	FP7	Equipment Repair	27
Nginx	Qt	Awesomeness	34
First Time Home Sellers	Citrix XenDesktop	Data Collection	17
Emergency Medicine	DCID 6/3	HR Management	34
Skin	Direct Mail	DPM	44
Vulnerability	Capital Equipment	SD	24
Data Modeling	CXF	Atmel AVR	37
LGBT Rights	CTIOS	DCS	34
Mobile Games	Public Speaking	NDT	40
Online Publishing	Blog Marketing	Hummingbird DM	38
DDIC	Recruitment Advertising	Kohana	44
HSRP	Urban Redevelopment	CME	40
XQuery	Xserve	VPM	3
Physical Security	TV Production	Mining	32
Bank Reconciliation	RPO	GNU/Linux	3
XP/Vista/7	Programming	Basel III	37
Jets	Radio Advertising	cGLP	15
TQC	Powers of Attorney	Loans	2
XPDL	OmniGraffle	Errors &amp; Omissions	12
Jewelry Design	Sports Medicine	FrameMaker	47
PY	Human Factors	IFC	41
RIS	RWD Info Pak	Dairy	21
JBoss Application Server	PPDS	Pyramix	29
Cultural Awareness	VLS	Jive SBS	17
DVCProHD	Non-profit Administration	Aquatic Therapy	40
FQHC	FMECA	Health Psychology	22
CMC	RSS	Wyse	33
Dbx	JCAPS	CFD	42
DHS	WFL	Drafting Agreements	13
Kodak	Lubrication	WDK	29
eGate	UIKit	Wastewater Treatment	4
RIS	HR Transformation	MKS	1
SQL PL	HDRI	Computer Network Operations	22
Xbox	Public Safety	KDB+	4
JCE	Machine Tools	Operating Systems	3
ITIL	Chemical Engineering	Subversion	26
Oil &amp; Gas Exploration	JavaBeans	Database Design	24
Petroleum	NT 4.0	BPA	29
Short Stories	Vocational Rehabilitation	Early Intervention	48
IOS-XR	Summation iBlaze	MMI	13
Renewable Energy	Ideas NX	SQL	46
JCR	UG	BBx	41
Kinect	Direct Marketing	VTL	2
PDM Works	CMS	Pneumatic Tools	13
LPC	Tween	Title Searches	36
GAAP	European Law	PMB	22
DHCP	Chi Nei Tsang	ICU	47
Disaster Recovery	PTO	Software Project Management	11
MCDBA	Switching	BS25999	9
Youth Ministry	FP7	UCM	20
Ocean Freight	Phase II Environmental Site Assessments	RF Engineering	14
Tally ERP	Overhead Cranes	Beer	6
SDS-PAGE	Scrum	NCPDP	5
Corporate Governance	PyGTK	Ulcerative Colitis	7
Clinical Psychology	Torts	XPath	35
Smart Metering	CVD	HMO	37
Judo	Ulcerative Colitis	XCAL	7
Channel Partners	Computer Science	ICP-MS	22
Medication Therapy Management	Budget Oversight	global HCM	33
Overseeing Projects	Lifestyle	Snowmobile	31
Social Media Outreach	CSRs	NYSE	40
Fine Art Photography	Hedge Funds	Etching	38
CentOS	Pharmaceutical Industry	Contract Management	19
Quality Management	Heavy Oil	BDC	6
UCP	OEM contracts	Analytics	4
Oracle Identity Manager	PDE	HCS	11
LTD	Nursing Process	University Teaching	15
CQI	Copy Typing	Income Tax	7
XML	SAP PP	Army	29
CCNP Certified	Permanent Placement	Youth Development	48
Home Equity Loans	NDS	Sensory Evaluation	2
Dyeing	eBanking	WFL	43
PTLLS	NSA-IAM	MSBuild	34
vCenter Server	HDI	CSM	46
Awk	Kurdish	Rollout	16
CPOE	SAP EWM	VW	43
EGPRS	QAQC	GPCRs	10
Equestrian	Term Life Insurance	NCIC	11
LLU	Commercial Property Owners	Corporate Finance	42
Game Design	European Integration	Web Services	39
Thin Films	Vray	Cash Flow	46
Google Earth	UV/Vis	HDS	1
International HR	Youth Development	CPI	9
DDR3	GPS	Leadership Development	24
Bodywork	Recruiting	TDI	22
Medical Devices	XTRAC	Spectroscopy	2
MGCP	Oracle BPM	Qt Creator	6
Mycobacteriology	Norwegian	Classroom	49
EZNews	Jimmy Jib	Microsoft Dynamics AX	50
Published Author	Content Strategy	DDIC	13
Non-fiction	Hybrid Cloud	Sweaters	37
Foreign Trade Zone	CFX	ODC	8
Health Insurance	Nanotechnology	Kinematics	8
JPA	Power Systems	Climate Change	44
Office Management	Policy Analysis	vCenter Server	10
XNA	Commercial Banking	Google Apps	49
SQL	Custom Furniture	Journal Entries	24
DMS-100	Company Set-up	Gigabit Ethernet	16
Veterinary Medicine	Grassroots	GCIA	3
Accounts Payable	QlikView	Freight	7
TSM Administration	BDCs	HtmlUnit	29
Aerohive	Jin Shin Jyutsu	Foreign Trade Zone	10
World War II	MXP	EBA	42
PDA	TBS	Lucene	12
Documentation	Slogans	401k Rollovers	41
Brand Management	Hummingbird DM	Twisted	2
Digital TV	Earned Value Management	TFM	19
Export	PMB	Festivals	22
Dry Eye	DFSS	ICD-9	49
TL9000	Contemporary Art	Snorkeling	6
NCDA	Syslog-ng	XFP	2
Lyophilization	Global Human Resources Management	Objection Handling	44
Blues	PC building	Talent Management	45
CDM	OmniGraffle	RDO	39
Norton Utilities	CG Lighting	Cisco Nexus	26
GPS Tracking	Knowledge Base	Substance Abuse Prevention	24
Flight Test	HSSE	Family Law	21
Power Utilities	Verilog	Xilinx ISE	41
Knowledge Base	Testing	Alternative Medicine	11
Funding	Apache	401k Rollovers	32
HS&amp;E	Zinc	Computer Graphics	35
Kinematics	WFC	QI	35
XSI	HTFS	CBI	5
Drug Development	RPAS	NG-SDH	22
Systems Design	Consumer Electronics	Workshops	11
MSS	CV	ETAP	43
Construction	Nylon	UK Tax	46
Routing	Slope Stability Analysis	VPython	39
HV	MTT	Target Identification	12
Style Guides	Audio Editing	Film Festivals	14
TV Distribution	SBEM	SEO	45
Shopper Marketing	IT Audit	DQL	28
MCSD	RF Design	RPT	14
MCDST	EBA	MPLS Networking	44
Catering	XOG	RTL Coding	12
PeopleSoft	Software Development	Quantum GIS	20
Amazon RDS	WWAN	Xcode	11
Kondor+	US Tax	LCD TV	48
OLTP	RF Test	DCOM	5
TSP	Basel II	NHibernate	10
Project Estimation	FTP	IT Service Delivery	24
Counseling Psychology	HR Policy Formulation	Joomla	14
Slip &amp; Fall	Equity Derivatives	IT Project &amp; Program Management	2
PVS	Customer Relations	Import	9
Ebooks	Functional Specifications	UTP	34
RF Engineering	Job Scheduling	DBs	4
Traditional IRA	KDB+	Church Growth	29
Automobile	Financial Risk	Hypnosis	28
Vulnerability Research	Reverse Osmosis	PgSQL	10
LLQP	DJ	Blackberry	3
Award Submissions	WLST	Water	5
Loan Origination	Variable Data Printing	Lymphedema	11
Egyptian Arabic	IGCC	Hardware	30
CGL	Governance	Foreign Affairs	7
Java Applets	Konica	Small Business Online Marketing	2
LDA	Pro Tools	UDS	1
Publications	Gynecologic Surgery	Csh	32
Beauty Industry	DLPAR	DFSS Green Belt	35
Wholesale Banking	CCTV	Vacation Homes	14
Social Skills	Microsoft Excel	Algorithm Design	43
iPhone Application Development	ASP.NET AJAX	Home Care	17
EU Funding	ABS	PMI	25
PDS	Ghost Imaging	Fortran	33
Canon DSLR	XML Databases	GCCS	46
Executive Administrative Assistance	RCS Selector	Bookkeeping	14
DVB-T	Fashion Design	OAM	34
Business Process	WLL	American Politics	41
Classical Guitar	XOG	Jenkins	16
Procurement	FME	NREMT	3
Mycobacteriology	Contractual Agreements	TK Solver	12
Rent to Own	Cashiering	Creative Strategy	15
SGSN	eWFM	Operational Excellence	49
Crisis Intervention	Blackberry OS	Voice Acting	37
IHT	Kurdish	LCSH	43
Roofers	NCDA	Film Production	33
Avid Newscutter	Following Up	Earth Science	8
HCS 2000	EOD	MRI	15
Business Object	Crystal Xcelsius	DMU	46
Fashion Blogging	Zeus	Juniper Switches	45
Pre-sales	Executive Coaching	AFM	44
Life Insurance	Lotus Notes	EOS	37
Audio Engineering	PPE	OTM	48
Operational Risk	HTML Scripting	Curating	12
Ethernet over SDH	CXO	Rock Mechanics	35
Zend Framework	Wicklander-Zulawski Interview &amp; Interrogation	Tax Research	14
Rapid Prototyping	MDR	BSC	24
Security Audits	VMware Player	BMPs	23
XPDL	TTL	Pilates	25
Term Life Insurance	Tomcat	Spring DM	2
ELISA	Wine	Yellow Book	7
Documentaries	JAX-RPC	SBT	18
Church Events	QKA	NSA-IAM	12
Hand Knitting	Computer Hardware	xCP	32
Snort	Kettlebells	UDDI	20
DSM-IV	Indoor Air Quality	Security Clearance	17
RCT	Software Quality Assurance	PK	9
JIS	Qbasic	JIS	32
LVM	DHCP	Sustainable Development	43
dsPIC	OLEDs	Snort	38
VMware Player	Menu Development	Multi-channel Retail	48
VCO	Estate Administration	Utility Industry	39
HR Solutions	Omnibus	DDoS Mitigation	24
SAP XI	OCP	HMIs	29
Cisco IOS	Piano	Aeronautics	28
VT	Participant Observation	XQuery	29
HDRI	Solid Oxide Fuel Cells	Writing	44
Data Mining	iOS Development	English	22
Global Management	Global Operations	Sickness Absence Management	49
Xilinx ISE	Small Business Development	UIKit	8
Financial Analysis	Event Production	PNF	35
Training Delivery	WTX	FDT	26
Behavior Management	SSEP	Urban Planning	19
Orthopedics	UL	Slovak	5
Wireless Networking	IASO	Zebra	12
PV Design	SWOT analysis	DVT	42
Technical Illustration	Illustration	nMarket	11
Ethics	RPC	Newspapers	32
Westlaw	Portraits	Outlook	42
Pdf	Animal Nutrition	HMIs	15
OECD	Linux Kernel	IELTS	38
Embedded Software	Volunteer Management	Athlete Development	42
Uzbek	Bass Guitar	PNF	6
Tortoise SVN	OKI	PDMS Draft	32
Abstracting	Financial Risk	Urban Regeneration	10
Affiliate Networks	eEye Retina	Award Ceremonies	23
FDICIA	Kondor+	Wireless Networking	6
Deep Tissue Massage	IVIG	Farms	10
Professional Liability	Business Objects Data Integrator	TSP	5
JiBX	Guerrilla Marketing	Wildlife	27
Evangelism	Class Actions	Food Industry	15
Blues	IVR	RFQ Development	15
Pneumatics	Book Illustration	CSCS Card	49
Driving Results	AJAX	UE	1
Zachman	Public Relations	GPP	44
RSVP	Technical Recruiting	TTS	49
Writing	CDO	Creative Writing	10
Uniform Combined State Law	nDo	Snooker	18
Utility Mapping	XML Publisher	QHSE	27
Eyewonder	DBWorks	Hyperion Reports	17
Guerrilla Marketing	Eastern Europe	ZFS	39
Ironport	MM7	Airline Ticketing	16
TCM	Zinc	Sellers	10
LCD	Emergency Room	DMZ	42
LPS Desktop	Fund Accounting	Radio Host	49
MSP Practitioner	SSOP	SNP genotyping	28
DITA XML	MMR	FTR	14
Website Development	Online Journalism	NPIV	11
CXF	Payroll	Equities	22
Journalism	Total Cost of Ownership	Web Analytics	33
Organizational Development	Kinetics	Multi-channel Retail	7
Human Capital Management	Venipuncture	Fences	41
Human Computer Interaction	Snowboarding	DSP BIOS	41
SRM 5.0	Kodak	Xenu	14
Key Account Management	Yamaha Digital Consoles	System Architecture	4
Zend	NHPA	MD5	38
Siebel	Ulcerative Colitis	Acoustic Guitar	9
FQHC	BFSI	ALM	18
Recruitment Advertising	Usability	NSN	38
American English	Culture Change	Kundalini	26
IT Governance	VDI	Easytrieve	38
Airline Ticketing	FTPS	Small Business Development	50
Test Automation	HR Strategy	IFM	25
Titration	Financial Accounting	Image Manipulation	13
Feature Articles	RS422	Petroleum Geology	31
Xserve	WDS	FPS	17
Computer Hardware	EWP	User Acceptance Testing	4
EHS	Undercover	Political Science	2
Audio Engineering	Portuguese	WDS	37
Agile Project Management	SBR	Claims Management	49
IR Spectroscopy	Oil Analysis	Fluid Dynamics	30
MCAD	Accounting	NHibernate	38
Occupational Therapists	HIPAA	Non-compete Agreements	18
JPA	cGLP	Aesthetic Surgery	12
EoMPLS	IGMP Snooping	TIG Welding	9
DC Power	Dual Diagnosis	RCT	28
HGV	HL7	Area Rugs	28
Academic Tutoring	European Law	QinQ	3
Grievances	PDM	RNO	16
EAI	PC Anywhere	FTO	9
Two-way Radio	EKG	PCI DSS	1
TPE	JCreator	VOD	35
QKA	TL9000	Acting	21
Nanoparticles	FX Animation	Performance Management	20
Property Management Systems	MDX	Customer Insight	45
OCLC Connexion	Operational Oversight	Citrix XenDesktop	13
TS2	HTML Help Workshop	ODE	17
Waterfall	Essential Oils	Warranty	38
Eagle PCB	CFRA	NUnit	25
Piano Education	Microsoft Dynamics SL	Igloo	48
Kaspersky	Sustainability	Junior Golf	20
Online Research	Corona SDK	JRun	7
MDRs	IGBT	Driving License	14
Snow Leopard	EIM	Lubricants	50
Jet Fuel	Oracle HR	Knowledge Representation	40
MKS Integrity	Hiring	Analog Circuit Design	37
CCNP Security	IT Strategy	Personal Training	27
Trail Running	Interviewing Skills	Occupational Medicine	40
Xactly	IATA	EELS	39
RVs	PGW	DNA electrophoresis	8
Biochemistry	VSTS	WLST	22
OmniGraffle	CPFR	FF&amp;E	43
IR	PVElite	GNU	27
BBQ	Ethnography	Siebel	11
Occupational Therapists	SVG	Application Architecture	28
Sustainable Agriculture	AAR	Microbiology	39
Copywriting	Systems Engineering	Nikon DSLR	24
Document Management	Capital Markets	Early Intervention	42
xPC Target	Earth Science	Coaching	14
CBCP	NCDA	Job Descriptions	48
Business Process	Corporate Events	HDL Designer	32
EViews	Jib	TGA	25
Buyer Representation	IT Project &amp; Program Management	Machine Tools	21
XP/Vista/7	JSON	Biopharmaceuticals	8
SAP Implementation	EFTPOS	Volunteer Recruiting	14
RF Engineering	UGS	Air Quality	8
Physical Oceanography	UED	Kyoto Protocol	33
Climate Change	Visual Effects	NIMS	40
Vendor Relationship Management	OTL	DGA	37
Patient Safety	Zen	RFQ Development	31
EOB	LDAR	Kinetics	41
Jive	Yahoo Search Marketing	WLI	26
Ultrasonic Testing	Cinema 4D	DFSORT	7
Kundalini Yoga	Audio Typing	AU	4
Oracle BPM	Environmental Impact Assessment	Dysarthria	42
Educational Leadership	FDD	RSoft	4
Financial Mgmt	Internet Banking	Following Up	9
BGAN	KOL Management	10 Key	38
DHTML	Water Quality	Multiplex PCR	14
Sybase SQL Anywhere	NGL	TV Distribution	42
Veneers	FTL	Bylined Articles	47
MbUnit	MbUnit	OB/GYN	14
Catalyst Switches	UCINET	PFT	19
Sun One LDAP	Gw Basic	Non-profit Board Development	45
Ocean	Numerical Analysis	Glazing	30
Ion Chromatography	Coastal Zone Management	Virtual PC	32
Oracle ERP	Land Development	Change Management	47
DTR	ZBrush	GT Strudl	12
Board of Directors	Foreclosures	Aerial Lifts	12
LAN-WAN	Agile Application Development	CentOS	23
JTAPI	Erwin	Knee Pain	2
Video Games	TQM	CBCP	42
PTC Creo	Functional Training	Ember.js	13
Light Rail	Wwise	PBX	2
Ultrasonic Testing	jQuery UI	SharePoint Server	18
Outside Sales	GSM	Agile &amp; Waterfall Methodologies	10
UCP 600	MCSD	CTF	28
ASME	HSIA	IEC	4
Fashion Photography	Board Certified	IIA Standards	46
Wind	PY	FTO	40
VxFS	Satellite TV	Data Warehousing	12
XSL	Commercial Property Owners	Citrix	37
Tcl-Tk	CTM	FF&amp;E Procurement	10
IRIS	MBD	RS232	39
Union Avoidance	RFP	Copy Typing	17
.htaccess	Abaqus	HAZOP Study	35
Koine Greek	MICROS	Lung	22
Retail	QEMU	RCS Selector	30
PFMEA	JConsole	FF&amp;E Procurement	32
Nagios	European Law	Open XML	49
Upstream	RFP Generation	Community Development	32
OHS	FP7	Curriculum Design	8
VLAN	Portrait Photography	Geomatics	5
Customer Follow-up	IVF	Vital Signs	10
CXF	In-situ Chemical Oxidation	Economics	36
WSAD	Zuken	Sqoop	33
ODS	Science Journalism	CVA	22
Tally ERP	TSW	BST	29
Childcare	Nslookup	EBR	18
TVC	Nmap	HR Management	30
Air Compressors	Critical Illness	HVAC	28
RTO	uCOS	Mathematical Modeling	38
Nitric Oxide	Land Use Planning	Budget Oversight	34
DVR	RFI	Jewish Education	41
IABP	Zoomerang	JCO	39
XRY	IGBT	Typo3	12
GSM-R	Radar	WSH	11
HTML	APO SNP	MS Integration Services	29
Real Estate Due Diligence	Pianist	HDSL	9
BSR Advance	Dynamic Speaker	Logging	39
Twill	Home Health Agencies	Functional Verification	37
QSIG	LAN Switching	WordPress	48
Core Java	MWS	iView	18
HBOC	Creativity Skills	Shipping	29
GNU/Linux	Assessment Center	Media Planning	4
Fashion Illustration	Hyperion Reports	Simulations	26
Social Media Outreach	CSLA	MDS 3.0	47
Knitting	Mixed Signal	HTFS	1
Ruby	Biopharmaceuticals	Graphic Design	49
Utility Regulation	VRS	UIX	27
Google Analytics	CCIM	Avid Newscutter	41
Hyperion EPM	QLab	CCNP	47
PTH	RUP	IP PBX	17
Juvenile Justice	Law Enforcement	PBUSE	2
MQSI	RTF	Kaseya	21
HPLC	IT Audit	InDesign	5
International Shipping	UCP	CQA	23
GSS	PL/SQL	OEL	48
BC/DR	Oxygen	HDL Designer	1
HLSL	Global Strategy	PPE	33
Type 1 Diabetes	Water Resources	XMLBeans	16
WSUS	Corporate Events	MRM	20
OEL	Network Design	Bank Reconciliation	5
EEO	OCR	NICET	37
GBS	Ghosts	HV	20
KDB+	Oligonucleotide Synthesis	Abstracting	30
Rural Marketing	Hair Care	TDA	18
Blood Pressure	Electronic Payments	PCS7	21
GPIB	SRTP	VSS	8
Qik	Creative Direction	Nuclear Engineering	32
Business Ideas	LPMS	ATG CSC	8
Health Insurance	Korean	SAP ERP	32
IaaS	RTO	Music Theory	43
ZeroMQ	HP NonStop	RF Design	29
Work Very Well with Others	SAP SD	Fund Of Funds	17
C-TPAT	Account Reconciliation	CTIOS	1
Order Fulfillment	JCR	Axioma	24
FDQM	Psychopharmacology	YAML	26
DDoS Mitigation	Ericsson OSS	LSAMS	48
SAP PM Module	Health Education	Qlogic	44
Fine Art Photography	Receptionist Duties	Research	10
Luxury	Logic Pro	VDSL2	28
GTD	FCNSP	First Time Home Buyers	28
GNSS	JDeveloper	QIP	30
Bash	Real Estate Development	Flyers	31
iFix	Ableton Live	JMS	5
Tcpdump	Unreal Editor	LSI	35
Data Integration	CNN Pathfire	PV Design	43
VMware vSphere	IASO	Process Scheduler	33
Quality by Design	Publications	Frame Relay	3
UCS	DxDesigner	Social Services	30
Underwriting	Critical Thinking	Oracle SQL Developer	10
Automotive	On Location	NCAA Compliance	5
Sun One LDAP	WLST	Athletics	7
VSD	RTU	Mobile Marketing	5
Flights	Integrated Marketing	IRB	10
Epi Info	eWFM	SBS	14
WebLogic	Space Planning	OS X	2
OAM	Sybase SQL Anywhere	Glassfish	49
Zen Shiatsu	Japanese Business Culture	Nursing Management	24
Curriculum Development	Tween	Special Education	37
CSV	UV disinfection	LDPC	13
eCTD	Tax Law	SFTP	9
Mysticism	MBS	Testing Types	50
Pyxis	Website Development	Multi-channel Retail	17
Keratin Treatment	Botany	WHMIS	30
Oncology	User Scenarios	Analytical Skills	13
IPSec	Wind Turbines	CA Unicenter NSM	36
JDOM	Rhinoplasty	Autism Spectrum Disorders	19
Switchboard Operator	Administrative Law	VDI	35
ASP.NET AJAX	Production Efficiency	WM modules	42
Client Relations	AOC	Appointment Scheduling	23
LLQP	iGrafx	Oil &amp; Gas Exploration	42
PMI	TDMoIP	Nielsen	18
Workshop Facilitation	Olefins	Pastoral Counseling	34
MBS	Avid DS Nitris	Affirmative Action	17
Agile &amp; Waterfall Methodologies	Freight	IVF	32
TL1	Odeon	DXL	25
NCARB	DTT	Gynecologic Oncology	36
Rheumatology	Dynamics	PTC Creo	25
jQTouch	Cultural Awareness	BMC Portal	44
Yellow Pages	Emergency Room	HCP	28
JMS	Aerial Photography	PgSQL	44
Evidence	MXG	Vlookup	21
Cost Benefit	Overseas Experience	C-TPAT	9
BPEL	IoC	xPON	25
VTC	ILM	AV	42
TCD	MVA	RRIF	1
Typeface Design	Brand Equity	NVU	49
BMV	MDB	Brocade Fibre Switches	20
Linux Kernel	DVD Authoring	Environmental Management Systems	27
Web Services	Erosion	Physical Security	35
SDH	Keratin Treatment	Eyelash &amp; Eyebrow Tinting	50
LEED AP	Supplier Evaluation	GFAS	17
XML Gateway	Objective-C	Twitter	35
Options	Job Search Strategies	Ethical Decision Making	4
Eaglesoft	BMR	SNP genotyping	33
HTML5	Physical Security	Start-up Consulting	44
Non-linear Editing	Overall Wellness	FCAPS	26
Investments	EPCM	EWP	28
PNF	Evidence	GDAL	44
Dyeing	Numerical Ability	SAP Business ByDesign	34
Up-selling	Tax Law	UltraTax	25
Pediatrics	Factory	DTMF	45
QAD	Yardi Property Management	Gcov	7
XACML	Swim Instruction	Distributed Systems	9
Ultipro	Database Marketing	IRS Enrolled Agent	21
Volunteer Management	MCH	Physicians	5
Brand Awareness	Clerical Skills	RFLP	8
Etching	Youth At Risk	Machine Tools	49
GMI	PCRF	VDA	7
XSS	SCADA	VTC	50
BJT	MDSD	Capital Markets	46
Kronos	RS422	Olive Oil	19
User Scenarios	SAP SD	Guitar Playing	8
Outdoor Recreation	JIT	pfSense	27
Hyper-V	PDMS	KWP2000	7
Cash Handling	Home Equity Loans	Marketing Communications	16
UV coating	Hand-drawn Typography	VA Loans	48
Usability Testing	DTS	XAUI	41
DDI Certified	Oracle	NLTK	15
ETAP	IAS 39	AutoCAD Civil 3D	31
JMS	XMetal	Natural Gas	36
KRA	DDR3	HEC-HMS	18
HLA	Dogs	BPF	14
DVD Duplication	Solvency II	Graphic Illustrations	21
MCITP	Eastern Europe	Framing	24
Sales Presentations	Twitter API	GHS	42
CNC Manufacturing	HCPCS	CTR	13
RF Systems	Vector Illustration	DHS	28
Submittals	WCDMA	Rhythm Guitar	34
Mixed-use	Energy Efficiency	Gaming Industry	35
JDOM	Kundalini Yoga	KMDF	20
Business Process	Food Quality	SFI	36
Object Oriented Perl	BMP design	Hg	29
EBA	ETABS	Land Use	23
ProSystem fx Tax	Bridge	TKI	1
Market Analysis	Type Design	Start-ups	49
DC-DC	Equipment Repair	KBOX	38
JSON-RPC	SNP genotyping	Employee Training	8
PK/PD	XCAP	Shotokan Karate	37
Wireless	Bodywork	GT Strudl	18
VxFS	TVCs	CMake	27
FX Trading	Wellness	WFL	46
ISO 9000	IES Virtual Environment	Linux System Administration	6
QinQ	MPEG	Aqualogic	39
Ulead VideoStudio	Order Picking	HP Procurve	28
Bankruptcy	NYS Notary Public	Bathrooms	22
DHCPv6	CNOR	Music History	26
FTTP	LCS	Kompozer	3
Athletic Performance	JSTOR	IPSec	45
MX Road	HDL Designer	Bands	15
Business Object	Real Estate Financing	Kinesiology	11
Water Resources	Government	MMIS	50
Consumer Electronics	IICRC Certified	Athletic Performance	30
At Multitasking	Short Films	Healthcare	44
Risk Management	Attorneys	Road	5
Registered Patent Attorney	Agrochemicals	Cisco IOS	20
EKG	Ab Initio	CQ5	20
Quest vWorkspace	Social Media Blogging	TPL	41
PTC Creo	SBT	Online Gambling	36
Affiliate Management	TSS	Vendor Relations	17
Teeth Whitening	DFMEA	Executive Search	33
Ecotect	IATSE	PTT	13
RDMA	Mac &amp; PC platforms	OSPF	14
Yahoo Search Marketing	Football	Surveying	27
BMD	Value Engineering	Operations Management	38
BPL	Pyrometallurgy	Navy	5
BC/DR	SFX Editing	Healing	45
NRP	QAQC	International Sales	32
Coaching	Network Architecture	Ethnography	37
Force Protection	RED MX	eHRPD	16
Health Insurance	Civil Rights	Psychological Assessment	5
PVCS	KOL Management	Olympic Lifting	3
DCS	RhinoCAM	PCB Design	49
Eyeliner	Typesetting	Women Owned Business	37
Medical-Surgical	PTLLS	Gas Turbines	1
NBAR	Capital Markets	Civil Rights	16
DVB-T	NLP	Banquets	46
AMI	Squid	RMAN	9
Judicial Review	RTL Design	iOS Development	14
Yields	UAG	nCloth	6
Copywriting	Juvenile Delinquency	eCTD	35
Pastoral Counseling	Total Cost of Ownership	FxCop	3
SRM	European Law	VPLS	14
Nuke	Capacity Building	Epigenetics	40
PDCA	Executive Coaching	Architectural Design	31
MBAL	Amazon Kindle	SD	49
RPG	Social Media Marketing	Kohana	7
What-if Analysis	MCSA Security	TPNS	5
LPG	Functional Verification	IB	23
BGA	BWA	Visual Studio	9
Sun Certified Java Programmer	ODD	CV	20
Blended Learning	MPEG-4	Computer Science	28
AAC	Wildlife	DFLSS	26
Verilog	Middle Eastern Studies	LPIC	29
Early Childhood Literacy	Commercial Property Owners	Power Systems	34
Core Banking	vCenter Server	Loans	32
Pro II	SVOD	Fixed Assets	26
iGrafx	Bhangra	Nursing Process	21
Business Planning	Solvency II	Animal Behavior	50
MySQLi	OTL	Xbox	39
Direct Marketing	Sage 300 ERP	Eye Exams	39
Korean	MQSI	IDoc	15
RFC	IES VE	Military	46
High Yield	ABAP Web Dynpro	Xactly Incent	26
Xajax	cPanel	Fund Of Funds	4
FPS	IBM Websphere Commerce	WDS	48
ZoomInfo	WCS	UltraEdit	18
XPages	DMC	BPMN	50
NUnit	Beauty Industry	Nanofabrication	24
Capacity Utilization	ATLS	XPages	21
Blueprint Reading	Computer Games	ALM	2
BMD	TMON	CXF	30
Editorial Illustrations	Cardiac Rhythm Management	FMV	20
Publicity	EOD	Working Abroad	50
Airline Management	PPDS	European Law	5
RTCP	Rhetoric	CQG	10
NICU	VNA	PPTP	16
Driven By Results	RSVP	Physics	24
Humanitarian Assistance	Online Gambling	Pivot Tables	26
Fume FX	SMSTS	OnQ	7
HTRI Software	ETL	Sun One LDAP	36
HCS	Yardi Voyager	RTLS	32
Online Travel	Fax	QSI	36
BIM	HST	Estate Jewelry	8
eGRC	Lucene	GHS	4
Vectorworks	NYMEX	OH&amp;S	24
Online Marketing	MVT	Manufacturing Operations Management	45
Qbasic	FGD	GMRA	18
HP uCMDB	BCA Protein Assay	TMG	11
ProSystem fx Tax	PXE	GSI	43
Histology	TPMS	Get Along Well with Others	29
Knowledge Representation	Appraisals	Metro Ethernet	47
Google Adwords	Financial Planning	SFR	29
LPS Desktop	VSE	ETL	26
FMCSR	Facebook	RNA	20
QSE	Construction Safety	Typography	48
Ambulatory Care	IBM Rational Tools	Psychology	22
Government	Kronos	ISDN	48
DVB-C	DLP	Test Driven Development	17
XSLT	Corporate Branding	iPhone	8
JiBX	Home Equity Loans	ATR-FTIR	1
Slovak	PBS	ODIN	4
Client Relations	Bankruptcy	Kindergarten	27
Qt Creator	NRA	Bootstrap	30
CTRS	Year-end Close	Environmental Impact Assessment	50
TDMA	RMF	SWAT	21
Eplan	PMB	Zynx	48
Object Oriented Software	Ion Implantation	DFD	12
BDCs	Board Certified	Pre-opening	49
Eye Exams	Window Displays	Oil Paint	22
Nitrous Oxide	XSL	Final Cut Pro	25
Army	PPPoA	DTI	11
Presentation Skills	Cisco Routers	HBase	47
BPWin	Options	PTH	11
RSL	IEEE standards	Jazz Dance	19
Laptops	IBM AIX	New Hire Training	13
Credit Analysis	NCLB	RDO	28
XBRL	Acoustic Guitar	Hypnosis	32
Glazing	ZoomInfo	WGA	7
GML	Contract Negotiation	RF Troubleshooting	39
FTC	MySpace	Bloomberg	5
Digital Illustration	EOQ	Fleet Management	20
Sports Injuries	JMeter	Alcoholic Beverages	29
Project Portfolio Management	Self-esteem	American History	10
Federal Government	BSP	Oil Changes	41
Window Displays	MVT	Business Transformation	25
MSP430	Pivot Tables	JMX	44
Family Medicine	Escrow	CSPO	17
Educational Outreach	AASHTO	RSVP	1
Software Project Management	TCAD	Business Analysis	26
Lynx	WTP	Bass Guitar	16
qRT-PCR	ODI	Xerces	47
Interviewing Skills	Cycle Time Reduction	Gynecologic Surgery	44
Kronos	LPCVD	GT Strudl	46
DNS	Oracle ERP	HR Management	26
ASP.NET AJAX	Autism Spectrum Disorders	Green Building	28
Wwise	Contact Centers	OLEDB	4
Poka Yoke	AOD	CTIOS	40
FTTP	Scheduling	Occupational Therapy	32
PMCS	FM/2	DVI	15
Turbines	Oncology	Year End Accounts	1
Power Electronics	Pneumatic Tools	VSA	19
AP Style	Urbanism	Sales Tax	18
Online Communications	HVAC	WF	2
Medical Devices	LDO	JPAS	21
HW/SW integration	BWA	Online Publishing	28
Google Adwords	MQL4	Mental Health	13
MSC Patran	Jeet Kune Do	ODI	33
Liability	Grant Writing	Real Estate Due Diligence	18
P&amp;ID	Navigation	DCN	41
Urban Infill	JMP	RRP	12
Small Boat Operations	Formation Evaluation	Ocean Transportation	27
Analog Circuit Design	Quest vWorkspace	WFL	38
Dublin Core	WDM	RSS	47
Sweaters	XMind	Airlines	13
FxCop	Critical Illness	ICT	9
American English	IEC 60601	Petroleum	7
CDMA	Igloo	Cashiering	20
Vulnerability Research	KBOX	JTAG	14
Automobile	Oracle XE	DVD Studio Pro	13
PnL Management	Jingles	MRP	48
NI Multisim	Critical Care	KOL Development	50
Brand Architecture	WSIB	Wellness Coaching	28
NGN	RC	PMC	35
RF Circuits	SAP PM Module	General Ledger	26
Pyrolysis	Cement	NX Unigraphics	21
McAfee Antivirus	Book Reviews	RTP	46
CFR	Identity Management	RDBMS	18
InDesign	FTTx	Flatbed	15
Gold	CCU	ODC	8
Evangelism	Aerospace Industries	Stakeholder Management	48
Feasibility Studies	VSTO	DNS Administration	25
Social TV	MDL	PnL Management	28
Weapons of Mass Destruction	Youth Programs	Military Training	46
DFU	Aerial Cinematography	Events Coordination	13
XACT	Web Services	Facilities Management	10
EWS	Tactics	HDLC	5
AKTA	IBM HTTP Server	Equipment Maintenance	17
Kaledo	Gourmet	Economic Research	44
ILOG	Alternative Dispute Resolution	EBIT	14
CWSP	Agarose Gel Electrophoresis	Mentoring	39
OllyDbg	Gas Chromatography	Aerial Cinematography	19
z/OS	Lytec	Web Content Management	32
CFR	Relationship Building	mLearning	38
MMI	Coastal Zone Management	CPR Instruction	40
PXE	Mixed-Signal IC Design	Breaking News	40
Ion Channels	Chemistry	CBRN	33
IEEE 802.11	Creative Direction	Immunohistochemistry	39
UGS	GFSI	Cold Calling	42
Subversion	Loans	Administrative Law	1
VMware Certified Professional	Scientific Writing	Board Development	6
Ember.js	Non-profit Board Development	Civil Litigation	7
VAS	YouTube	Young Adults	44
HR Software	Photoshop	AAMS	8
Land Use	Zooarchaeology	BGA	50
MDF	RV	CME	21
Passionate about work	BGA	DDE	4
21 CFR Part 11	CBEST	Oracle OLAP	18
DFA	BD+C	PMP	4
E-zines	ArcGIS	VMS	46
Global Business Development	DDR2	MP2	27
Drywall	Spot TV	Underground Mining	38
Yarn	Japanese Culture	Public Sector	35
TCAS	Small Business Development	Family Therapy	35
CPCU	PDMS Draft	Iron	32
BBEdit	Ultrasound Therapy	LUSAS	28
LPT	SLES	Ember.js	7
ISTQB	XLSTAT	Curating	25
Histology	Kyocera	NMR	12
Gas Turbines	FSC certified	EOU	22
CNC Mill	Two-factor Authentication	jQTouch	47
Cellular Communications	OA Framework	Blackberry OS	42
Thermal Oxidation	Voiceovers	MX960	48
Style Guides	VTP	RHIA	16
